R 900 640

SO textures/wall_1.xpm

NO textures/wall_2.xpm

EA textures/wall_4.xpm

WE textures/wall_3.xpm

S textures/sprite_1.xpm

F 64,64,45
C 155,100,79
       1111111111111111111111111
        1000000000000000000000001
        1100000000000000000000001
        10S0000000000000000000001
111111111000000000000000000000001
100002000000002000000000000001111
10000111100000000000000000001
100001  100000000200000000001
10000111100000000000000000001
1000000000000000000000000001
10000000000000000001010000001
11000001110101011111011110101
11110111 1110121 101111010001
11111111 1111111 111111111111
